1,2-a,1,1,1,1,1,1,1,1
1,2,1,1,3,3,3,3,3,1
1,2,1,1,3,5,5,5,3,1
1,2,1,1,3,5,5,5,3,1
1,2,1,1,3,5,5,3,3,1
1,2,2,2,2,2,2,2,2,2-b
1,2,1,1,1,1,1,1,1,1
1,2,1,1,6,6,6,6,6,6
1,2,1,1,6,6,6,6,6,6
1,2,1,1,6,6,6,6,6,2
1,2,1,1,6,6,6,6,6,6
1,2-c,1,1,6,6,6,6,6,6